##############################.######################################
#.....#.#....................#.#.........#............#.....#.....###
#.#.#.#.#.####.########.######.##...#######.#.##########...#####.####
#.#.#.#......#......#........#..#.........#...#...#....#...........##
#.#.#.######...#############...###............###...######.#######.##
#.#.#........#...#......#..#.#...#.##########.#...###.......#......##
#.#.##########.####.#####.##.#####..........#.#.#.###.###############
#.#.#.#.#.#.#..#..#.#...#.##.#.....##########.###.#.#.#............##
#.#.#.........#..####.....#....#####..................############.##
#.#.####.######.##....#.######.#...#.###########.####..............##
#.#.............#..####.########......#..........#....###############
#.###################################################################
