############################.#####################################
##.#.#.....................#.#.........#............#.....#.....##
##.#.####.########.######.##...#######.#.##########...#####.######
##.#......#......#........#..#.........#...#...#....#...........##
##.######...#############...###............###...######.#######.##
##........#...#......#..#.#...#.##########.#...###.......#......##
###########.####.#####.##.#####..........#.#.#.###.###############
##.#.#.#.#..#..#.#...#.##.#.....##########.###.#.#.#............##
##.........#..####.....#....#####..................############.##
#####.######.##....#.######.#...#.###########.####..............##
##...........#..####.########......#..........#....###############
####################################.#############################
