#.#########
#.........#
#.####.##.#
#....#.#..#
####.#.####
#.........#
#.#######.#
#.........#
#########.#