##########.#######
#................#
#.##############.#
#......#.........#
######...#########
#......#.........#
#.##############.#
#.#..............#
#.################
